----------------------------------------------------------------------------------------------------------------------------------------------------------------------------------------------------
----------------------------------------------------------------------------------------------------------------------------------------------------------------------------------------------------
----------------------------------------------------------------------------------------------------------------------------------------------------------------------------------------------------
----------------------------------------------------------------------------------------------------------------------------------------------------------------------------------------------------
----------------------------------------------------------------------------------------------------------------------------------------------------------------------------------------------------
------------------------------------------------------------------------------SS-------------------------------------------------------X------------------------------------------------------------
----------------------------------------------------------------------------------------------------------------------------------------------------------------------------------------------------
----------------------------------------------------------------------------------------------------------------------------------------------------------------------------------------------------
----------------------------------------------------------------------------------------------------------------------------------------------------------------------------------------------------
---------------------------------------------------------------------XXXX--------------X---------------------------------------------X--------------------------------------------------------------
----------------------------------------------------------------------------------------------------------------------------------------------------------------------------------------------------
------------------------------------------------------------------X---------------------------------------------------------------------------------------------------------------------------------
-----------------------------------------------------------XX-E----------------E---E----------------------------------------------------------------------------------------------------------------
XXXXXXXXX-XXXXXXXXXXXXXXXXXXXXXXXXXX--XXXXXXXXXXXXXXXXXXXXXXXXXXXXXXXXXX-XXXXXXXXXXXXX--XXXX--X----XXXXXXXXXXX----------------XX-----XXXXXXXXXXXXXXXXXXXXX-XXXXXXXXXXXXXXX--------XXXXXXXXXXXXXXXXXX
