--------Q-----------------------------------------------XXXXXXXXXXXXXXXXXXXXXXXXXXXX----------------------------ESSSXSXX<>[Q>SE<S]Q<X>??>?<<--------------------------------------------------------
---------------------X---X------------------------------XXXXXXXXXXXXXXXXXXXXXXXXXXSX----------------------------[[<SQ<Q?SS?Q<S]S?]?Q<ES[??Q<--------------------------------------------------------
----SSS-SSSS----SS-SSSS-SS-SSSSS-SSSSSSSSSSSSSSS--SS-SSSXXXXXXXXXXXXXXXXXXXXXXXXXXXX----------------------------XQ[]>[>EX]][>XEX<]QQEQQQ]Q<Q----------------------------SSSSSSSSSSSSSSSSSSSSSSSSSSSS
------S-------S-------S---------------------------------?S?XS?XSXXXXXXX?XXXX?SSXSSXS----------------------------]]>]><][[<[>[<<>]>]<>><[[[<>--------------------------------------------------------
---S--X---S------------S--S-----S-----------------------???S?SSSSSSS?SSSS?SS?SSSSSSS----------------------------QQ><Q<>QQ><Q><[>]Q]>Q>][Q<Q<--------------------------------S-----------------------
-----SS---------X-X----------------------------------?--<EEEE<<<<<E<<<<<<<<E<<<<<<<<------------------------S---]]]]>>[<]>][<][>]]<][]]]]<><-----------------------------------------------------?--
----X-------------XXXX-----<----------------------------????SSSSS?SSSSSSSSSSSSSSSS??----------------------------Q]?[[QQ?QQ[QQ]]][]Q[]]??]?[?--------------------------------------------------------
X---X-X]---[------X-X-----------------------------------S??SSS???SS?SS?SSSSSSSSSSSSS----------------------------?Q<QQQ?Q?Q???Q?[?????QQ?Q?QQ--------------------------------------------------------
----X-----------X-X---XXX--X--------------------S-------????????????????????????????----------------------------?]QQQQQQQ<]<QQQQQQQQQQQQQQQQ------------------------------------------------S-------
----X-<<-XX--]XX-X<>-X-----S---S--------------------Q---][[[[?<<][[[[][[[]<>[[[[[?[]------------------------Q---][[[]]<<][[[[]]][]<>][[[[][]-------------------------------S----------------S-------
-------------<[XXX[XX------X----------------------------S?SS???SSS?SSSSSS?SSSSSSSSS?----------------------------QQQQQQQQQQQQQ<[QQQ[QQQQQQQQQ-----------------------------X-------------------------X
--X---->--X-XXX]XXXXX<-XX-XX---<-]-->X-----------------[S?SS?SSSSS?SSSSSSSSSS?SSSSSS-----]-->-------------------??QQQ?Q>????????QQ???<QQQQQ?-----]-------------------------<-]-X>X-----------------X
--------X]-X-X-XX-[XX--X-XEX---X--X------------E--------??SSSSSSSSSSSSSSSSSSS??????S----------------------------??QQ?>>><QQ?<>Q??>??QQQ?<><?-------------------------------X--X------------E--------
XXXXXXXXXXXXXXXXXXXXXXXXXXXXXXXXXXXXXXXXXXXXXXX-XXXXXXXXSSSSSSSSSSSSSSSSSSSSSSSSSSSSXXXXXXX-XXX-XXXXXXXXXXXXXXXX<SE??><<QE<?S?>]?>S><Q>QSQE]XXXXXXXXXXXXXXXXXXXXXXXXXXXXXXXXXXXXXXXXXXXXXXX-XXXXXXXX
