----------------------------------------------------------------------------------------------------------------------------------------------------------------------------------------------------
----------------------------------------------------------------------------------------------------------------------------------------------------------------------------------------------------
----------------------------------------------------------------------------------------------------------------------------------------------------------------------------------------------------
----------------------------------------------------------------------------------------------------------------------------------------------------------------------------------------------------
------------------------------------------X---------------------------------------------------------------------------------------------------------------------------------------------------------
----------------------------------------------------------------------------------------------------------------------------------------------------------------------------------------------------
----------------------------------------------------------------------------------------------------------------------------------------------------------------------------------------------------
----------------------------------------------------------------------------------------------------------------------------------------------------------------------------------------------------
-----------------------------------------------------S----------------------------------------------------------------------------------------------------------------------------------------------
----------------------------------------------------------------------------------------------------------------------------------------------------------------------------------------------------
---------------]-----------XX-------------------------------------------------X--------------------]-----------------------------------------------------------------------------------------------X
------------------------------X-------------------------------------------------------------------------------------------------------------------------------------------------------------------X-
-E-EEEEE------------------EXX-------------------------E----------------------XXE-----EEXEEE---E---------------EX-----------------------------E-XEE--------------------EE-E--EEE--EE---------EE-E--EX
XXXXXXXXXXXXXXXXX---XXXXXXXX-XX-XXXXXXX-------XXXXXXXXXXXXXXXXXXXXXX-XXXXXXXXXXXXXXXXXXXXXXXXXX---X---XXXXXXXXXXXXXXXXXXXX-XXXXXXXXXXXXXXXXXXXXXXXXXXXX--XX----XXXXXXXXXXXXXXXXXXXXX--XXXXXXXXXXXXXX
